41
15
26 26 26 26 26 26 26 26 26 26 26 26 26 26 26 26 26 26 26 26 26 26 26 26 26 26 26 26 26 26 26 26 26 26 26 26 26 26 26 26 26 
26 0 0 0 0 0 0 0 0 0 0 0 0 0 26 0 0 0 0 0 0 0 0 0 0 26 0 0 0 0 0 0 0 0 0 0 0 0 0 0 26 
26 0 0 0 0 0 0 0 0 0 0 0 0 0 26 0 0 0 0 0 0 0 0 0 0 26 0 0 0 0 0 0 0 0 26 0 0 0 0 0 26 
26 0 0 0 0 0 0 0 0 0 0 26 0 0 26 0 0 0 0 0 0 26 0 0 0 26 0 0 0 0 0 0 0 26 26 0 0 0 0 0 26 
26 0 0 0 0 0 0 0 0 0 0 26 0 0 0 0 0 0 0 0 0 26 0 0 0 0 0 0 0 0 0 0 26 26 26 0 26 0 0 0 26 
26 0 0 0 0 0 0 0 26 0 0 26 0 0 0 0 0 26 0 0 0 26 0 0 0 0 0 0 26 0 0 26 26 26 26 0 0 0 0 0 26 
26 0 0 0 0 26 0 26 26 26 26 26 26 26 26 26 26 26 26 26 26 26 26 26 26 26 26 26 26 26 26 26 26 26 26 26 26 26 26 26 26 
26 0 0 0 0 0 0 0 0 0 0 0 0 0 0 0 0 0 0 0 0 0 0 0 0 0 5 0 0 5 0 0 5 0 0 0 0 0 0 0 26 
26 26 0 0 0 0 0 0 0 0 0 0 0 0 0 0 0 0 0 0 0 0 0 0 0 0 26 0 0 26 0 0 26 0 0 0 0 0 0 0 26 
26 0 0 0 0 0 0 0 0 0 0 0 0 0 0 0 0 0 0 0 0 0 0 0 0 0 26 0 0 26 0 0 26 0 0 0 0 0 0 0 26 
26 26 26 26 26 26 26 26 26 26 26 26 26 26 26 26 26 26 26 26 26 26 26 26 26 26 26 26 26 26 26 26 26 26 26 26 0 0 0 0 26 
26 0 0 0 0 0 0 0 0 0 0 26 0 0 0 26 0 0 0 0 0 26 0 5 0 5 0 5 0 5 0 5 0 0 0 26 0 0 0 26 26 
26 26 26 26 9 0 0 0 0 5 0 1 0 5 0 0 0 0 0 0 0 0 0 26 0 26 0 26 0 26 0 26 0 0 0 0 0 0 0 0 26 
26 0 0 0 0 0 5 0 0 26 0 0 0 26 0 0 0 0 0 0 0 26 0 0 5 0 5 0 5 0 5 0 5 0 0 26 0 0 0 0 26 
26 0 0 0 0 10 26 9 0 26 26 9 0 26 0 0 0 0 26 26 26 26 26 0 26 0 26 0 26 0 26 0 26 0 0 26 0 0 0 0 26 
