21
16
26 0 0 0 0 0 0 0 0 0 0 0 0 0 0 0 0 0 0 0 26 
26 0 0 0 0 0 0 0 0 0 0 0 0 0 0 0 0 0 0 5 26 
26 0 0 0 0 0 0 0 0 0 0 0 0 0 0 0 0 0 10 26 26 
26 0 0 0 0 0 0 0 0 0 0 0 0 6 7 7 8 0 0 3 26 
26 0 0 0 0 0 0 0 0 0 0 0 0 25 26 26 27 0 0 0 26 
26 0 0 0 0 0 0 0 6 7 8 0 0 0 0 0 0 0 0 0 26 
26 0 0 0 5 0 0 0 25 26 27 0 0 0 0 0 0 0 0 0 26 
26 0 0 10 26 9 0 0 0 0 0 0 0 0 0 0 0 0 0 0 26 
26 0 6 7 7 8 0 0 0 0 5 0 0 0 6 7 7 8 0 0 26 
26 0 25 26 26 27 0 0 0 10 26 9 0 0 25 26 26 27 0 0 26 
26 0 0 0 0 0 0 0 0 0 1 0 0 0 0 0 0 0 0 5 26 
26 0 0 0 0 0 0 0 0 0 0 0 0 0 0 0 0 0 10 26 26 
26 0 0 0 0 0 0 0 0 0 0 0 0 0 5 0 0 5 0 3 26 
26 0 0 0 5 0 0 0 5 0 0 0 5 10 26 9 10 26 9 0 26 
26 7 7 7 26 7 7 7 26 0 0 0 26 0 1 0 0 1 0 0 0 
26 26 26 26 26 26 26 26 26 0 0 0 26 0 0 0 0 0 0 0 0 
